R  1111             800

S ./textures/chest.xpm

C 70,70,70
F 250,250,250

EA ./textures/grey.xpm
SO ./textures/wall_1.xpm

WE ./textures/wall_1.xpm
NO ./textures/brick.xpm


1111
1001
1001
1201
1201
1201
1201
1201
1201
1201
1001
1001
1001
1001
1001
1001
1001
1001111
1000001
1N00001
1000001
1001111
1111 11
1111
1001
1001
1001
1001
1001
1111
1
1
1
111
121
111
101
1111
