R  15000 15000
NO ./textures/brick.xpm
SO ./textures/wall_1.xpm
WE ./textures/wood.xpm
EA ./textures/grey.xpm

S ./textures/chest.xpm
C 70,70,70
F 250,250,  250

1111
1001
1001
1001
1001
1001
1001
1001
1001
1001
1001
1001
1001
1001
1001
1001
1001
1001
1001
1S01
1001
1001
1001
1001
1001
1001
1001
1111