R  25800 17200
NO ./textures/brick.xpm
SO ./textures/blue.xpm
WE ./textures/wood.xpm
EA ./textures/grey.xpm

S ./textures/chest.xpm
F 224,172,105
C 205,249,255

     111111111111111111111
     100001100000000000001
     100011100020000000011
     10000011100000000W0011
     1000011 10000000000001
     1000001 10000011101111
     111111111111111111111111
     111111111011100000011
     111111111011101010001
     100011010101100000001
     100000000000000000001
     100000000000110101001
     100011010101111101111
     111111110101111101111
     111111111111111111111111

