R  1500 1500
NO ./textures/brick.xpm
SO ./textures/wall_1.xpm
WE ./textures/wood.xpm
EA ./textures/grey.xpm

S ./textures/chest.xpm
C 70,70,70
F 250,250,  250


111111111      111111111                    1111111 1111111                  
1E00000011     100000001                    1000001 1000001                 
1100000001     100000001                    100000111000001
 1100000011    110000001                    1100000111000011                  
  111000001    100000111    11111111111111   1100001 1100001   1111111111111   
    10000011   11000001   111000000000000111  100001  100001 11100000000000111 
    1000000111110000001  110000001111100000111100001  100001 10000000000000001
    1000000000000000001  100000011   110000000000001  100001 10000011111000001
    1000000000000000001  100000001111100000011100001  100001 1000011   1100001
    1000000111110000001  10000000000000000011 100001  100001 100001     100001
    10000011   11000001  1000000111111111111  100001  100001 100001     100001
   11000001     1000001111100000001          11000011110000111000011   1100001
  110000001     10000000000000000011         100000011000000110000011111000001
  100000001     100000001110000000011111111  100000000000000000000000000000001
  100000001     100000001 11100000000000001  100000011000000111100000000000111 
  111011111     111111111   111111111111111  1111111111111111  1111111111111   
    101
   11011111     11111111    111111111111111111 
  110000001    110000001    100000000000000001 
  100000001    100000001    100000000000000001 
  111000001    111000001    100000111111111111 
    1100001      1100001    1000001            
     100001       100001    1000001            
     100001       100001    10000011111111111  
     100001       100001    100000000000000011  
     100001       100001    1111111111110000011 
     100001       100001               11000001
     100001       100001                1000001
    11000011     11000011 1111111111   11000001
  111000000111111100000011100000000111110000001
  100000000000100000000000001110000000000000111 
  100000000000000000000000111 111000000000111   
  1111111111111111111111111     11111111111